#.###.####.####.###.#
.....................
#.###.#########.###.#
#...................#
#f#.#.#f# # #f#.#.#f#
........# g #........
#f#.#.#f#####f#.#.#f#
#...................#
#.###.#########.###.#
..........p..........
#.###.####.####.###.#