##.##.####.####.##.##
##....####.####....##
##.ff...........ff.##
##....####.####....##
##.##.####.####.##.##
##........g........##
##.##.####.####.##.##
##....####.####....##
##.ff.....p.....ff.##
##....####.####....##
##.##.####.####.##.##