############.##
##..........f##
##.#.##########
##.#.........##
##.#########.##
##.#.......#.##
##.#.#####.#.##
##.#.#  g#.#.##
##.#.# ###.#.##
##.#.#p....#.##
##.#.#######.##
##.#f........##
##.############
##f..........##
############.##