######################
#f..................f#
#.#######.# ########.#
#.........#g#........#
#.#.##.##.###.##.###.#
#....................#
#.########.#.#######.#
...........#.#........
#.##.##.####.####.####
#..#p#..............f#
######################